#################################
# #     # #   #####   # #     # #
# # # ### # # ##### # # ### # # #
#   #       #       #       #   #
### # ### # ######### # ### # ###
    #   # #           # #   #
### ### # ### ##### ### # ### ###
        #     #   #     #
### # # # ### # # # ### # # # ###
### # #     #   #   #     # # ###
### # # ### # # # # # ### # # ###
#################################