###################################
###   # #     # ### #     # #   ###
##### # # # ### ### ### # # # #####
# #   #   #   #     #   #   #   # #
# # # # # ### # ### # ### # # # # #
#   #     #     ###     #     #   #
### ### # # # # ### # # # # ### ###
    #   #   #         #   #   #
### # # ### ##### ##### ### # # ###
#     #                     #     #
# ##### # # # # ### # # # # ##### #
###################################