##########
#  # #   #
#  # #   #
#  # #   #
#### #####
#        #
#### #####
#  # #   #
#  # #   #
##########